
NO   ./text/purplestone.xpm 

WE ./text/greystone.xpm

SO    ./text/bluestone.xpm   

EA   ./text/redbrick.xpm  


C  146, 191, 255

S   ./text/coin1   .xpm 

F   22, 184     ,     135
R      1201     200 
    


11111111111111111
10000000000000001
10001111100000001
10021    10000001
10S01    10000001
10001111110001001
10222000000000101
10000000122222101
10000001000000001
11111111111111111


