
NO ./text/purplestone.xpm
R      1723      1660
WE ./text/greystone.xpm
SO    ./text/bluestone.xpm            
EA ./text/redbrick.xpm            
C  146, 191, 255
S ./text/coin1.xpm

F   22, 184    ,      135

11111111111111111
10000000000000001
10001111100000001
10S21    10000001
10001    10000001
10001111110001001
10222000000000101
10000000222222101
10000000000000001
10000000000000001
10222222222222101
11111111111111111